R 1920 1080


NO ./pics/colorstone.xpm
SO ./pics/wood.xpm
EA ./pics/redbrick.xpm
WE ./pics/eagle.xpm
S ./pics/fire.xpm

C 155, 221, 255
F 27, 18, 9


111111111111111111
100000000220000001
1000000000N0000001
111121110000011111
100000000000000001
100000000000000001
100000000000000001
100000000000000001
111111111111111111